11111
10P01
10A01
10E01
11111
