11111
10C01
10001
10P01
11111
