11111
10C01
10001
10E01
11111
