111111111111111111111111111111111111111111111111
100000010000000000000000000100000000000SS0000001
100000011111000000000000000011000000010C00100001
100000000000110E00001111111111100000000S00011101
10000000000001000000000000000000111C000000000001
10000000000001PS0000000011100011100C000S00000001
111111111111111111111111111111111111111111111111
